################################################################################
#I   P                        VVVVVVVVVVVVVVVVVVVVVVVVVVVVVVVVVVVVVVVVVVVVVVVVV#
#   ####                      VVVVVVVVVVVVVVVVVVVVVVVVVVVVVVVVVVVVVVVVVVVVVVVVV#
#   ####                      VVVVVVVVVVVVVVVVVVVVVVVVVVVVVVVVVVVVVVVVVVVVVVVVV#
#                             VVVVVVVVVVVVVVVVVVVVVVVVVVVVVVVVVVVVVVVVVVVVVVVVV#
#VVV                         #             VVVVVVVVVVVVVVVVVVVVVVVVVVVVVVVVVVVV#
#VVVV    ########            #            VVVVVVVVVVVVVVVVVVVVVVVVVVVVVVVVVVVVV#
# VVVV   #      #            #            VVVVVVVVVVVVVVVVVVVVVVVVVVVVVVVVVVVVV#
#  V     #      #            #            VVVVVVVVVVVVVVVVVVVVVVVVVVVVVVVVVVVVV#
#        #      ###########  #            VVVVVVVVVVVVVVVVVVVVVVVVVVVVVVVVVVVVV#
#    V   #                   #            VVVVVVVVVVVVVVVVVVVVVVVVVVVVVVVVVVVVV#
#        #                   #            VVVVVVVVVVVVVVVVVVVVVVVVVVVVVVVVVVVVV#
#        # ###################            VVVVVVVVVVVVVVVVVVVVVVVVVVVVVVVVVVVVV#
#                                         VVVVVVVVVVVVVVVVVVVVVVVVVVVVVVVVVVVVV#
#                  V         #            VVVVVVVVVVVVVVVVVVVVVVVVVVVVVVVVVVVVV#
#                            #            VVVVVVVVVVVVVVVVVVVVVVVVVVVVVVVVVVVVV#
#  #######################   #            VVVVVVVVVVVVVVVVVVVVVVVVVVVVVVVVVVVVV#
#                        #   #            VVVVVVVVVVVVVVVVVVVVVVVVVVVVVVVVVVVVV#
#  #                     #   #            VVVVVVVVVVVVVVVVVVVVVVVVVVVVVVVVVVVVV#
#  #                         #            VVVVVVVVVVVVVVVVVVVVVVVVVVVVVVVVVVVVV#
#  #                     #####            VVVVVVVVVVVVVVVVVVVVVVVVVVVVVVVVVVVVV#
#  #                         #            VVVVVVVVVVVVVVVVVVVVVVVVVVVVVVVVVVVVV#
#  #                                      VVVVVVVVVVVVVVVVVVVVVVVVVVVVVVVVVVVVV#
#  #  ########################            VVVVVVVVVVVVVVVVVVVVVVVVVVVVVVVVVVVVV#
#  #                         #             VVVVVVVVVVVVVVVVVVVVVVVVVVVVVVVVVVVV#
#  #                         #            VVVVVVVVVVVVVVVVVVVVVVVVVVVVVVVVVVVVV#
#  #                         #            VVVVVVVVVVVVVVVVVVVVVVVVVVVVVVVVVVVVV#
#  #                         #            VVVVVVVVVVVVVVVVVVVVVVVVVVVVVVVVVVVVV#
#  #                         #            VVVVVVVVVVVVVVVVVVVVVVVVVVVVVVVVVVVVV#
#  #                         #             VVVVVVVVVVVVVVVVVVVVVVVVVVVVVVVVVVVV#
#  #                         #            VVVVVVVVVVVVVVVVVVVVVVVVVVVVVVVVVVVVV#
#  #                         #            VVVVVVVVVVVVVVVVVVVVVVVVVVVVVVVVVVVVV#
#  #                         #            VVVVVVVVVVVVVVVVVVVVVVVVVVVVVVVVVVVVV#
#                            #            VVVVVVVVVVVVVVVVVVVVVVVVVVVVVVVVVVVVV#
#  #                                       VVVVVVVVVVVVVVVVVVVVVVVVVVVVVVVVVVVV#
#  #                                      VVVVVVVVVVVVVVVVVVVVVVVVVVVVVVVVVVVVV#
#  #                                      VVVVVVVVVVVVVVVVVVVVVVVVVVVVVVVVVVVVV#
#  #                         #            VVVVVVVVVVVVVVVVVVVVVVVVVVVVVVVVVVVVV#
#                            #            VVVVVVVVVVVVVVVVVVVVVVVVVVVVVVVVVVVVV#
################################################################################
